........#..##################......#..............
........#...................#......#..............
........#..#................#......############...
...@....#..#................#.................#...
...........#..#################..###..........#...
........#..#.......................#..........#...
........#..#=======..========..##..############...
#########..#................=..##.................
...........#................=..##....#############
..##########................=..##....#............
..#........#=================..##.....#...........
..#............................##......#.....#....
..#........#......##########...##.......#....#....
..#....#####......#........#...##........#####....
..#....#..........#........#...##.................
.......#...#..#####............##......###########
..#....#...#......#....#####...##.....#...........
..#....#...#......#....#.......##....#............
..######...#......#....#.......##...##########....
...........#......#....#..........................